R 1280 800

NO ./textures/brick.xpm
SO ./textures/metal.xpm
WE ./textures/stone.xpm
EA ./textures/wood.xpm
S ./textures/sprites/pillar.xpm

C 138,71,124
F 255,0,0

1111111111111111111111111
1000000000110000000000001
1011000001110000002000001
1001000000000000000000001
1111111110110000011100001
1000000000110000011101111
1111011111111101110000001
1111011111111101110101001
1100000011010101110000001
1000200000000000110000001
1000000000000000110101001
1100000111N10101111101101
1111011111110101110111101
1111111111111111111111111
