R 800 600

NO ./textures/brick.xpm
SO ./textures/metal.xpm
WE ./textures/stone.xpm
EA ./textures/wood.xpm
S ./textures/sprites/pillar.xpm

C 138,71,124
F 255,0,0

1111111
100N001
1111111